16 12
c d c c c c c c c c c c c c c c
c b b b b b c c c b b b b c c c
c b c c c b c b b b c c b c c c
c b b b c b c b c c c c b c c c
c c c b c b c b b b b c b c c c
c b b b c b c c c c b c b b b c
c b c c c b b b b c b c c c b c
c b c b c c c c b c b c b c b c
c b c b c b b b b b b c b b b c
c b b b c b c c c c c c c c b c
c c c b c b b b c b b b b b b c
c c c c c c c e c c c c c c c c
